1 1 5 1 4 4 4 4 4 4 4 4 4 4 4 4 4 4 4 4 4 4 4 4 4 4 4 4 4 4 4 4 4 4 4 4 4 4 4 4 4 4 4 4 4 4 4 4 4 4 
1 1 5 1 4 4 4 4 4 4 4 4 4 4 4 4 4 4 4 4 4 4 4 4 4 4 4 4 4 4 4 4 4 4 4 4 4 4 4 4 4 4 4 4 4 4 4 4 4 4 
1 1 5 1 4 4 4 4 4 4 4 4 4 4 4 4 4 4 4 4 7 7 7 7 1 1 7 4 4 4 4 4 4 4 4 4 4 4 4 4 4 4 4 4 4 4 4 4 4 4 
1 1 5 1 4 4 4 4 4 4 4 4 4 4 4 4 4 4 4 4 2 2 2 5 2 2 2 4 4 4 4 4 4 4 4 4 4 4 4 4 4 4 4 4 4 4 4 4 4 4 
1 4 5 4 4 4 4 4 4 4 4 4 4 4 4 4 4 4 4 4 2 2 2 5 2 2 2 4 4 4 4 4 4 4 4 4 4 4 4 4 4 4 4 4 4 4 4 4 4 4 
1 4 5 4 4 4 4 4 4 4 4 4 4 4 4 4 4 4 4 4 2 2 2 5 5 5 5 5 5 5 5 5 5 5 5 5 5 4 4 4 4 4 4 4 4 4 4 4 4 4 
1 4 5 4 4 4 4 4 1 1 1 1 1 4 4 4 4 4 4 4 4 2 2 5 2 2 4 4 4 4 4 4 4 4 4 4 5 4 4 4 4 4 4 4 4 4 4 4 4 4 
1 4 5 4 4 4 4 4 1 3 3 3 1 4 4 4 4 4 4 4 5 5 5 5 5 5 5 4 4 4 4 4 4 7 8 5 5 1 1 1 1 1 1 4 4 4 4 4 4 4 
1 4 5 4 4 4 4 4 1 3 3 3 1 4 4 4 4 4 4 4 4 5 5 5 5 5 4 4 4 4 4 4 4 4 8 2 5 2 6 6 6 6 1 4 4 4 4 4 4 4 
1 4 4 4 4 4 4 4 1 3 3 3 1 4 4 4 4 4 4 4 4 4 5 5 5 4 4 4 4 4 4 4 4 4 8 5 5 5 6 6 6 6 1 4 4 4 4 4 4 4 
1 4 4 4 4 4 4 4 1 3 3 3 1 4 4 4 4 4 4 4 4 4 4 5 4 4 4 4 4 4 4 4 4 4 8 2 5 2 1 9 6 6 1 4 4 4 4 4 4 4 
1 4 4 4 4 4 4 4 1 1 5 1 1 4 4 4 4 4 4 4 4 4 4 5 1 6 6 6 1 1 1 4 4 4 8 5 5 6 6 6 6 6 1 4 4 4 4 4 4 4 
1 4 4 4 4 4 4 4 4 4 5 4 4 4 4 4 4 4 4 4 4 4 4 5 4 4 4 4 4 4 4 4 4 4 4 5 5 5 5 1 1 1 1 4 4 4 4 4 4 4 
1 4 4 4 4 4 4 4 4 4 5 4 4 4 4 4 4 4 4 4 4 4 4 5 4 4 4 4 4 4 4 4 4 4 4 4 4 4 5 4 4 4 4 4 4 4 4 4 4 4 
1 4 4 4 4 4 4 4 4 4 5 4 4 4 4 4 4 4 4 4 4 4 4 5 5 0 4 4 4 4 4 4 4 4 4 4 4 4 5 4 4 4 4 4 4 4 4 4 4 4 
4 4 4 4 4 4 4 4 4 4 5 4 4 4 4 4 4 0 0 0 0 0 0 5 4 4 4 4 4 4 4 4 4 4 4 4 4 4 5 4 4 4 4 4 4 4 4 4 4 4 
4 4 4 4 4 4 4 4 5 5 5 4 4 4 4 4 4 0 0 0 0 0 4 5 4 4 4 4 4 4 4 4 4 4 4 4 4 4 5 4 4 4 4 4 4 4 4 4 4 4 
4 4 4 4 4 4 4 4 5 4 4 4 4 4 4 4 4 0 0 0 0 4 4 5 4 4 4 4 4 4 4 4 4 4 4 4 4 4 5 4 4 4 4 4 4 4 4 4 4 4 
4 4 4 4 4 4 4 4 5 4 4 4 4 4 4 4 4 0 0 0 0 4 7 5 7 4 4 4 4 4 4 4 4 4 4 4 5 5 5 4 4 4 4 4 4 4 4 4 4 4 
4 4 4 4 4 4 4 4 5 4 4 4 4 4 4 4 4 0 0 0 0 7 7 5 7 7 4 4 4 4 4 4 4 4 4 4 5 4 4 4 4 4 4 4 4 4 4 4 4 4 
4 4 4 4 4 4 4 4 5 4 4 4 4 4 4 4 4 4 4 4 7 7 0 5 0 7 7 4 4 4 4 4 4 4 4 5 5 4 4 4 4 4 4 4 4 4 4 4 4 4 
4 4 4 4 4 4 4 4 5 4 4 4 5 5 5 5 5 5 5 5 5 5 5 5 5 5 5 5 5 5 5 5 5 5 5 5 5 4 4 4 4 4 4 4 4 4 4 4 4 4 
4 4 4 4 4 4 4 4 5 4 4 4 5 4 4 4 4 4 4 4 7 7 0 5 0 7 7 4 4 4 4 4 4 4 4 4 5 4 4 4 4 4 4 4 4 4 4 4 4 4 
4 4 4 4 4 4 4 4 5 4 4 4 5 4 4 4 4 4 4 4 4 7 7 5 7 7 4 4 4 4 4 4 4 4 4 4 5 4 4 4 4 4 4 4 4 4 4 4 4 4 
4 4 4 4 4 4 4 4 5 4 4 4 5 4 4 4 4 4 4 4 4 4 7 5 7 4 4 4 4 4 4 4 4 4 4 4 5 4 4 4 4 4 4 4 4 4 4 4 4 4 
4 4 4 4 4 4 4 4 5 4 4 4 5 5 5 4 4 4 4 4 4 4 4 5 4 4 4 4 4 4 4 4 4 4 4 4 5 4 4 4 4 4 4 4 4 4 4 4 4 4 
4 4 4 4 4 4 4 4 5 4 4 4 4 4 5 4 4 4 4 4 4 4 4 5 4 4 4 4 4 4 4 4 4 4 4 4 5 4 4 4 4 4 4 4 4 4 4 4 4 4 
4 4 4 4 4 4 4 4 5 4 4 4 4 4 5 4 4 4 4 4 4 4 4 5 4 4 4 0 4 4 4 4 4 4 4 0 5 4 4 4 4 4 4 4 4 4 4 4 4 4 
4 4 4 4 4 4 4 4 5 4 4 4 4 4 5 4 4 4 4 4 4 4 4 5 4 4 4 4 4 4 0 4 4 4 4 4 5 4 4 4 4 4 4 4 4 4 4 4 4 4 
4 4 4 4 4 4 4 4 5 2 2 2 2 2 5 4 4 4 4 4 4 4 4 5 4 4 4 4 4 4 0 4 4 4 4 4 5 4 4 4 4 4 4 4 4 4 4 4 4 4 
4 4 4 4 4 4 4 4 5 7 7 7 7 7 5 4 4 4 4 4 4 4 4 5 4 4 4 4 4 4 4 4 4 4 4 4 5 4 4 4 4 4 4 4 4 4 4 4 4 4 
4 4 4 4 4 4 4 4 5 7 7 7 5 5 5 4 4 4 4 4 4 4 4 5 4 4 4 4 4 4 4 4 4 4 4 7 5 7 4 4 4 4 4 4 4 4 4 4 4 4 
4 4 4 4 4 4 4 4 5 5 5 5 5 7 7 4 4 4 4 4 4 4 4 5 4 4 4 4 4 4 4 4 4 4 4 7 5 7 4 4 4 4 4 4 4 4 4 4 4 4 
4 4 4 4 4 4 4 4 7 7 7 7 7 7 7 4 4 4 4 4 4 4 4 5 4 4 4 4 4 4 4 4 4 4 4 7 5 7 4 4 4 4 4 4 4 4 4 4 4 4 
4 4 4 4 4 4 4 4 7 7 7 7 7 7 7 4 4 4 4 4 4 4 4 5 4 4 4 4 4 4 4 4 4 4 4 7 5 7 4 4 4 4 4 4 4 4 4 4 4 4 
4 4 4 4 4 4 4 4 4 4 4 4 4 4 4 4 4 4 4 4 4 4 4 5 4 4 4 4 4 4 4 4 4 4 4 7 5 7 4 4 4 4 4 4 4 4 4 4 4 4 
4 4 4 4 4 4 4 4 4 4 4 4 4 4 4 4 4 4 4 1 1 1 1 5 1 1 1 1 1 1 1 4 4 4 7 7 5 7 7 4 4 4 4 4 4 4 4 4 4 4 
4 4 4 4 4 4 4 4 4 4 4 4 4 4 4 4 4 4 0 1 2 2 2 5 2 2 2 2 2 2 1 4 4 2 2 2 5 7 7 4 4 4 4 4 4 4 4 4 4 4 
4 4 4 4 4 4 4 4 4 4 4 4 4 4 4 4 4 4 0 1 2 2 2 5 2 2 2 2 4 2 1 4 2 2 2 2 5 7 7 4 4 4 4 4 4 4 4 4 4 4 
4 4 4 4 4 4 4 4 4 4 4 4 4 0 4 4 4 4 0 1 2 5 5 5 5 5 5 2 2 2 1 4 2 2 2 2 5 5 5 4 4 4 4 4 4 4 4 4 4 4 
4 4 4 4 4 4 4 4 4 4 4 4 4 4 4 4 4 4 0 1 2 5 2 2 2 2 5 0 2 2 1 2 2 2 2 2 5 7 5 5 4 4 4 4 4 4 4 4 4 4 
4 4 4 4 4 4 4 4 4 4 4 4 4 0 4 4 4 4 4 1 2 5 2 2 2 2 5 4 2 2 1 2 2 2 5 5 5 7 5 4 4 4 4 4 4 4 4 4 4 4 
4 4 4 4 4 4 4 4 4 4 4 4 4 4 4 4 4 4 4 1 2 5 5 5 5 2 6 4 2 2 1 2 2 4 5 7 5 7 5 4 4 4 4 4 4 4 4 4 4 4 
4 4 4 4 4 4 4 4 4 4 4 4 4 4 4 4 4 4 4 1 2 2 4 4 5 4 4 4 2 2 1 2 2 2 5 7 5 7 5 4 4 4 4 4 4 4 4 4 4 4 
4 4 4 4 4 4 4 4 4 4 4 4 4 4 4 4 4 4 4 1 2 2 4 4 5 4 4 4 2 2 1 4 4 4 5 4 5 4 4 4 4 4 4 4 4 4 4 4 4 4 
4 4 4 4 4 4 4 4 4 4 4 4 4 4 4 4 4 4 4 1 4 4 4 4 5 5 5 5 5 5 5 5 5 5 5 5 5 4 4 4 4 4 4 4 4 4 4 4 4 4 
4 4 4 4 4 4 4 4 4 4 4 4 4 4 4 4 4 4 4 1 1 1 1 1 1 1 1 1 1 1 1 4 4 4 4 4 4 4 4 4 4 4 4 4 4 4 4 4 4 4 
4 4 4 4 4 4 4 4 4 4 4 4 4 4 4 4 4 4 4 4 4 4 4 4 4 4 4 4 4 4 4 4 4 4 4 4 4 4 4 4 4 4 4 4 4 4 4 4 4 4 
4 4 4 4 4 4 4 4 4 4 4 4 4 4 4 4 4 4 4 4 4 4 4 4 4 4 4 4 4 4 4 4 4 4 4 4 4 4 4 4 4 4 4 4 4 4 4 4 4 4 
4 4 4 4 4 4 4 4 4 4 4 4 4 4 4 4 4 4 4 4 4 4 4 4 4 4 4 4 4 4 4 4 4 4 4 4 4 4 4 4 4 4 4 4 4 4 4 4 4 4 