1 1 1 1 1 1 1 1 7 1 1 7 1 1 1 1 1 5 5 7 1 1 1 1 1 1 1 1 7 7 1 1 1 1 1 1 1 1 1 1 1 1 1 1 1 1 1 1 1 1 
1 1 1 1 1 1 1 1 7 1 1 7 1 1 1 1 1 5 5 1 1 1 1 1 1 1 1 1 7 1 1 1 1 1 1 1 1 1 1 1 1 1 1 1 1 1 1 1 1 1 
1 1 1 1 1 1 1 1 1 6 7 1 1 1 1 1 1 7 6 1 1 1 1 1 1 1 1 1 1 1 1 1 1 1 1 1 1 1 1 1 1 1 1 1 1 1 1 1 1 1 
1 7 1 1 1 1 1 1 1 1 1 1 1 1 1 1 1 1 1 1 1 1 1 1 1 1 1 1 1 1 1 1 1 1 1 1 1 1 1 1 1 1 1 1 1 1 1 1 1 1 
1 1 6 1 1 1 1 1 1 1 1 1 1 1 1 1 1 1 1 1 1 1 1 1 1 1 1 1 1 1 1 1 1 1 1 1 1 1 1 1 1 1 1 1 1 1 1 1 1 1 
1 1 1 1 1 9 9 9 9 9 9 9 9 9 9 9 9 9 9 9 9 9 9 9 9 9 9 9 9 9 9 9 9 9 9 9 9 9 9 9 9 9 9 9 9 1 1 1 1 1 
1 1 1 5 1 9 9 9 9 9 9 9 9 9 9 9 9 9 9 9 9 9 9 9 9 9 9 9 9 9 9 9 9 9 9 9 9 9 9 9 9 9 9 9 9 1 1 1 1 1 
1 7 1 1 1 9 9 9 9 9 9 9 9 9 9 9 9 9 9 9 9 9 9 9 9 9 9 8 9 9 9 9 9 9 9 9 9 9 9 9 9 9 9 9 9 1 1 1 1 1 
6 1 1 1 1 9 9 9 9 9 9 9 9 9 9 9 9 9 9 9 9 9 9 9 9 9 8 8 9 9 9 9 9 9 9 9 9 9 9 9 9 9 9 9 9 1 1 1 1 1 
1 1 1 1 7 7 9 9 9 9 9 9 9 9 9 9 9 9 9 9 9 9 9 9 9 7 6 7 9 9 9 9 9 9 9 9 9 9 9 9 9 9 9 9 9 1 1 1 1 1 
1 1 1 1 1 6 8 9 9 9 9 9 9 9 9 9 9 9 9 9 9 9 9 9 9 3 3 6 9 9 9 9 9 9 9 9 9 9 9 9 9 9 9 9 9 1 1 1 1 1 
1 1 1 1 1 6 5 9 9 9 9 9 9 9 9 9 9 9 9 9 9 9 9 9 9 0 1 6 9 9 9 9 9 9 9 9 9 9 9 9 9 9 9 9 9 1 1 1 1 1 
1 1 1 1 1 7 5 9 9 9 9 9 9 9 9 9 9 9 9 9 9 9 9 9 9 0 1 6 9 9 9 9 9 9 9 9 9 9 9 9 9 9 9 9 9 1 1 1 1 1 
7 6 6 1 1 9 9 9 9 9 9 9 9 9 7 6 9 9 9 9 9 9 8 8 9 9 9 9 9 9 9 9 9 9 9 9 9 9 9 9 9 9 9 9 9 1 1 1 1 1 
5 5 7 1 1 9 9 7 9 9 9 9 9 9 7 7 9 9 9 9 9 9 9 9 9 9 9 9 9 9 9 9 9 9 9 9 9 9 9 9 9 9 9 9 9 1 1 1 1 1 
2 2 1 7 1 9 9 2 3 8 9 9 9 9 8 9 9 9 9 9 9 9 9 9 9 9 9 9 9 9 9 9 9 9 9 9 9 9 9 9 9 9 9 9 6 1 1 1 1 1 
1 1 1 1 7 9 9 0 0 3 7 9 9 8 9 9 9 9 9 9 9 9 9 9 9 9 9 9 9 9 9 9 9 9 9 9 9 9 9 9 9 9 9 9 0 1 7 1 1 1 
1 1 1 1 1 8 9 0 0 0 4 7 9 7 9 9 9 9 9 9 9 9 9 9 9 9 9 9 9 9 9 9 9 9 9 9 9 9 9 9 9 9 9 9 0 1 1 1 1 1 
1 1 1 1 1 7 9 0 0 0 3 6 9 6 9 9 9 9 9 9 9 9 9 9 9 9 9 9 9 9 9 9 9 9 9 9 9 9 9 9 9 9 8 9 0 1 1 1 1 1 
1 1 1 1 1 9 9 9 9 9 9 8 8 9 9 9 9 9 9 9 9 9 9 9 9 9 9 7 9 9 9 9 9 9 9 9 9 9 9 9 6 4 7 9 9 1 1 1 1 1 
1 1 1 1 1 9 9 9 9 9 9 9 7 9 9 9 9 9 9 9 9 9 9 9 9 9 8 7 9 9 9 9 9 9 9 9 9 9 9 9 6 5 7 9 9 1 1 1 1 1 
1 1 1 1 1 9 9 9 9 9 9 9 8 9 9 9 9 9 9 9 9 9 9 9 9 8 6 5 7 9 9 9 5 6 9 9 9 9 9 7 6 5 8 9 9 1 1 1 1 1 
1 1 1 1 1 9 9 9 9 9 9 9 8 9 9 9 9 9 9 9 9 9 9 9 9 3 2 2 4 8 9 9 0 1 5 9 9 9 5 5 6 7 9 9 9 1 1 1 1 1 
1 1 1 1 1 9 9 9 9 9 9 9 9 9 9 9 9 9 9 9 9 9 9 9 9 0 0 0 2 5 9 9 0 0 1 7 9 9 1 3 5 8 9 9 7 1 1 1 1 1 
1 1 1 1 1 9 9 9 9 9 9 9 9 9 9 9 9 9 9 9 9 9 9 9 9 0 0 0 0 3 7 9 0 0 0 5 9 9 0 2 5 8 9 9 6 1 1 1 1 1 
1 1 1 1 1 9 9 9 9 9 9 9 9 9 9 8 9 9 9 9 9 5 4 6 9 9 9 9 7 5 5 9 9 9 9 9 9 9 9 9 9 9 9 9 9 1 1 1 1 1 
1 1 1 1 1 9 9 9 9 9 9 9 9 9 9 8 9 9 9 9 9 5 4 6 9 9 9 9 7 5 5 9 9 9 9 9 9 9 9 9 9 9 9 9 9 1 1 1 1 1 
1 1 1 1 1 9 9 7 8 9 9 9 9 9 9 9 9 9 9 9 9 7 5 6 9 9 9 8 5 4 6 9 9 9 9 9 9 9 9 9 9 9 9 9 8 1 1 1 1 1 
1 1 1 1 1 9 9 2 5 9 9 9 9 9 9 9 9 9 9 9 9 9 7 7 9 2 4 5 2 4 7 9 6 9 9 9 9 9 9 9 9 9 9 9 1 6 1 1 1 1 
1 1 1 1 1 9 9 0 2 9 9 9 9 9 9 9 9 9 9 9 9 9 9 8 9 0 0 0 2 3 8 9 0 3 7 9 9 9 8 9 8 7 8 9 0 1 1 1 1 1 
1 1 1 1 1 6 9 0 0 8 9 9 9 9 9 9 9 9 9 9 9 9 9 8 9 0 0 0 0 3 9 9 0 0 4 9 9 9 7 7 6 5 7 9 0 1 1 1 1 1 
1 1 1 1 1 4 9 0 0 8 9 9 9 9 9 9 9 9 9 9 9 9 9 7 8 0 0 0 0 4 9 9 0 0 4 8 9 9 6 6 5 5 6 9 0 1 1 1 1 1 
1 1 1 1 1 2 7 9 9 9 9 9 9 3 2 3 5 7 8 8 6 4 3 3 7 9 9 9 9 9 9 9 9 9 9 9 9 9 9 9 9 8 8 9 9 1 1 1 1 1 
1 1 1 1 1 0 5 8 9 9 9 9 9 5 4 5 6 7 6 9 6 4 3 5 8 6 9 9 9 9 9 9 9 9 9 9 9 9 9 9 9 8 8 9 9 1 1 1 1 1 
1 1 1 1 1 0 4 3 9 9 9 9 9 9 7 7 8 7 5 9 9 6 4 4 7 1 4 8 9 9 9 9 9 9 9 9 9 9 9 9 9 9 8 9 4 1 1 1 1 1 
1 1 1 1 1 0 3 0 3 9 9 9 9 9 9 9 9 8 6 9 9 9 6 4 7 0 0 4 9 9 9 9 9 9 9 9 9 9 9 9 9 9 8 9 0 1 1 7 1 1 
1 1 1 1 1 0 3 0 1 8 9 9 9 9 9 9 9 9 6 9 9 9 6 5 7 0 0 1 8 9 9 9 9 9 9 9 9 9 9 9 9 9 8 9 0 1 1 1 5 1 
1 1 1 1 1 0 3 0 0 7 9 9 9 9 9 9 9 9 6 9 9 9 7 5 7 0 0 0 8 9 9 9 9 9 9 9 9 9 9 9 9 9 8 9 0 1 1 1 1 1 
1 1 1 1 1 9 9 9 9 9 9 9 9 9 9 9 9 9 9 9 9 4 2 3 7 9 9 9 9 9 9 9 9 9 9 9 9 9 9 5 0 0 4 9 9 1 1 1 1 1 
1 1 1 1 1 9 9 9 9 9 9 9 9 9 9 9 9 9 9 9 9 6 4 4 7 9 9 9 9 9 9 9 9 9 9 9 9 9 9 5 1 1 5 9 9 1 1 1 1 1 
1 1 1 1 1 9 9 9 9 9 9 9 9 9 9 9 9 9 9 9 9 9 9 7 9 9 9 9 9 9 9 9 9 9 9 9 9 9 9 6 4 5 8 9 9 1 1 1 1 1 
1 1 1 1 1 9 9 4 9 9 9 9 9 9 9 9 9 9 9 9 9 9 9 9 9 9 9 9 9 9 9 9 9 9 9 9 9 9 8 8 8 9 9 9 9 1 1 1 1 1 
1 1 1 1 1 9 9 0 5 9 9 9 9 9 9 9 9 9 9 9 9 9 9 9 9 9 9 9 9 9 9 9 9 9 9 9 9 9 7 9 9 9 9 9 9 1 1 1 1 1 
1 1 1 1 1 9 9 0 3 9 9 9 9 9 9 9 9 9 9 9 9 9 9 9 9 9 9 9 9 9 9 9 9 9 9 9 9 9 6 9 9 9 9 9 9 1 1 1 1 1 
1 1 1 1 1 8 9 9 9 9 9 9 9 9 9 9 9 9 9 9 9 9 9 9 9 9 9 9 9 9 9 9 9 6 4 6 9 9 9 9 9 9 9 9 9 1 1 1 1 1 
1 7 2 1 1 1 1 1 1 1 1 1 1 1 1 1 1 1 1 1 1 1 1 1 1 1 1 1 1 1 1 1 1 7 5 6 1 1 1 1 1 1 1 1 1 1 1 1 1 1 
1 5 2 1 1 1 1 1 1 1 1 1 1 1 1 1 1 1 1 1 1 1 1 1 1 1 1 1 1 1 1 1 1 1 1 1 1 1 1 1 1 1 1 1 1 1 1 1 1 1 
1 2 1 1 1 1 1 1 1 1 1 1 1 1 1 1 1 1 1 1 1 1 1 1 1 1 1 1 1 1 1 1 1 1 1 1 1 1 1 1 1 1 1 1 1 1 1 1 1 1 
1 1 1 2 5 1 1 1 5 1 1 1 1 1 1 1 1 1 1 1 1 1 1 1 1 1 1 1 1 1 1 1 1 1 1 1 1 1 5 1 1 1 1 1 1 1 1 1 7 1 
1 1 1 2 5 1 1 1 2 1 1 1 1 1 1 1 1 1 1 1 1 1 1 1 1 1 1 1 1 1 1 1 1 1 1 1 1 1 1 6 1 1 1 1 1 1 1 1 6 1 
